type octile
height 16
width 16
map
................
................
................
................
................
................
................
................
............@...
...........@....
...........@....
...........@....
...........@....
......@@@@@.....
................
................
